111111111111
100000000001
10000000000S
100000000001
100000000001
100000000001
111111101111
10000100000F
100001000001
100001000001
100000000001
111111111111