11111F11S111
100000000001
100000000001
100000000001
100000000001
100000000001
111111101111
100001000001
100001000001
100001000001
100000000001
111111111111